01111111111111111112
99999999999999999999
99999999999999999999
99999999999999999999
99999999999999999999
31111111111111111118