01111114444441111112
44444444444444444444
44444444444444444444
44444444444444444444
44444444444444444444
67777774444447777778